丶	dot		
丨	vertical line		
亅	hook		
丿	slash		
几	table	desk	
儿	legs		
乂	regulate		
冂	upside-down box		
亠	kettle lid		
勹	wrapping enclosure		
匸	hiding enclosure		
亻	thin person		
厶	katakana mu		
卩	crooked seal		
冖	cower		
冫	ice		
凵	open box		
刂	knife		
厂	cliff		
匚	box-on-side		
彐	pig snout		
彑	crooked pig snout		
弋	shoot with bow		
夂	go		
兀	towering	lofty	
廾	two hands		
尸	corpse with flag		
囗	closed box		
宀	roof with chimney		
于	out of		
巛	curving river		
幺	short thread		
广	dotted cliff		
阝	mound (left) / town (right)		
廴	long stride		
彡	bristle	short hair	
彳	step with left foot		
扌	small hand		
忄	thin heart		
尢	lame		
氵	water drops		
屮	sprout		
壬	9th in rank		
戈	spear		
歹	bare bone		
灬	fire sparks		
尹	official rank		
攵	rap	hit, strike	
辶	walking on a road		
殳	weapon		
气	blowing a steam		
礻	cult		
毋	do not		
爿	split wood		
夬	certain		
禾	grain on stalk	rice plant	
乍	while		
衤	clothes on mannequin		
氺	water splash		
罒	small net		
疒	sickness		
癶	footsteps		
旡	choke	sob	
亦	also		
虍	tiger stripes		
艮	northeast	stopping	
聿	pencil	writing brush	
耒	handle of plow		
舛	opposite		
耂	old grave		
豕	pig		
豸	badger		
釆	distinguish		
其	that		
隹	small bird		
隶	servant		
兔	hare		
飠	eat less		
巷	alley	lane	
韋	tanned leather		
樣	way	manner, shape, form, pattern, style	
一	one	one	one
二	two	two	two
三	three	three	three
四	four	four	four
五	five	five	five
六	six	six	six
七	seven	seven	seven
八	eight	eight	eight
九	nine	nine	nine
十	ten	ten	ten
口	mouth	mouth	mouth
日	day	day, sun, Japan	day
月	month	moon, month	month, moon
田	rice field	rice field	rice paddy
目	eye	eye, item	eye
古	old	old	old
吾	I	I	
冒	risk	risk	risk
朋	companion	comrade	
明	bright	bright, clear	bright
唱	chant	sing	chant
晶	sparkle	crystal	sparkle
品	goods	article	article
呂	spine	phonetic (ro)	spine
昌	prosperous	prospering	
早	early	early, quick	early
旭	rising sun	rising sun	
世	generation	world, age	world
胃	stomach	stomach	stomach
旦	nightbreak	daybreak	daybreak
胆	gallbladder	gallbladder	gall bladder
亘	span	extend over	
凹	concave	concave	concave
凸	convex	convex	convex
旧	olden times	former	old times
自	oneself	self	oneself
白	white	white	white
百	hundred	hundred	hundred
中	in	middle, in	middle
千	thousand	thousand	thousand
舌	tongue	tongue	tongue
升	measuring box	sho	measuring box
昇	rise up	ascend	rise up
丸	round	round	circle
寸	measurement	a bit of	measurement
専	specialty	exclusive	specialty
博	Dr.	extensive, doctor	Dr.
占	fortune-telling	occupy, divine	fortune telling
上	above	up	up
下	below	down	below
卓	eminent	table, prominent	eminent
朝	morning	morning, dynasty	morning
只	only	free of charge, ordinary	
貝	shellfish	shellfish	shellfish
貞	upright	chaste	upright
員	employee	member	member
見	see	see	see
児	newborn babe	child	child
元	beginning	origin	origin
頁	page	page	
頑	stubborn	stubborn	stubborn
凡	mediocre	commonplace	mediocre
負	defeat	bear, lose	lose
万	ten thousand	ten thousand	ten thousand
句	phrase	phrase, haiku	phrase
肌	texture	skin	texture
旬	decameron	ten-day period	10-day period (of the month)
勺	ladle	shaku	
的	bull’s eye	target, adjectival suffix	target
首	neck	head, neck, leader	neck
乙	fishguts	second	the latter
乱	riot	disordered	riot
直	straightaway	straight, fix	straight
具	tool	implement	tool
真	true	true	true
工	craft	manufacture, construction	craft
左	left	left	left (direction)
右	right	right	right (direction)
有	possess	have	have
賄	bribe	bribe	bribe
貢	tribute	tribute	tribute
項	paragraph	clause	paragraph
刀	sword	sword	sword
刃	blade	blade	blade
切	cut	cut	cut
召	seduce	summon	summon
昭	shining	luminous	shining
則	rule	rule	rule
副	vice-	secondary	vice
別	separate	separate, another	separate
丁	street	town subsection, miscellaneous counter	ward
町	village	town	town
可	can	~able, approve	possible
頂	place on the head	summit, receive humbly	place on the head
子	child	child, noun suffix	child
孔	cavity	open hole	cavity
了	complete	finish, comprehend	finish
女	woman	woman	woman
好	fond	like, favorable	like
如	likeness	as	likeness
母	mama	mother	mother
貫	pierce	penetrate	pierce
兄	elder brother	older brother	older brother
克	overcome	overcome	overcome
小	little	small	small
少	few	little	few
大	large	big, university	large
多	many	many	many
夕	evening	evening	evening
汐	eventide	tide	
外	outside	outside	outside
名	name	name	name
石	stone	stone	stone
肖	resemblance	model	resemblance
硝	nitrate	niter	nitrate
砕	smash	crush up	smash
砂	sand	sand	sand
削	plane	cut by chipping	plane
光	ray	light	ray
太	plump	great, thick	thick
器	utensil	vessel, instrument	container
臭	stinking	bad smell	stinking
妙	exquisite	marvelous	exquisite
省	focus	ministry, save, introspect	government ministry
厚	thick	thick, kind	thick
奇	strange	unusual	strange
川	stream	river	river
州	state	state	state
順	obey	order, obey	obey
水	water	water	water
氷	icicle	ice	ice
永	eternity	eternal	eternity
泉	spring	spring	spring
原	meadow	plain, original	field
願	petition	wish, ask a favor	request
泳	swim	swim	swim
沼	marsh	muddy pond	marsh
沖	open sea	offing	open sea
江	creek	inlet	inlet
汁	soup	juice, soup	soup
潮	tide	tide	tide
源	source	source	origin
活	lively	active, live	active
消	extinguish	extinguish, spend	extinguish
況	but of course	conditions	condition
河	river	river	river
泊	overnight	stay overnight	overnight
湖	lake	lake	lake
測	fathom	measure, conjecture	fathom
土	soil	soil	soil
吐	spit	spew	spit
圧	pressure	pressure	pressure
埼	cape		cape (geography)
垣	hedge	fence	hedge
圭	square jewel	sharp corner	
封	seal	seal	seal
涯	horizon	outer limits	horizon
寺	buddhist temple	buddhist temple	Buddhist temple
時	time	time	time
均	level	even	level
火	fire	fire	fire
炎	inflammation	flame, inflammation	inflammation
煩	anxiety	vexed	anxiety
淡	thin	light	thin
灯	lamp	lamp	lamp
畑	farm	field	farm
災	disaster	natural calamity	disaster
灰	ashes	ash	ashes
点	spot	point	point
照	illuminate	illuminate	illuminate
魚	fish	fish	fish
漁	fishing	fish	fishing
里	ri	countryside, league	village
黒	black	black	black
墨	black ink	india ink	black ink
鯉	carp	carp	
量	quantity	quantity	quantity
厘	rin	rin	thousandth
埋	bury	bury	bury
同	same	same	same
洞	den	cave	den
胴	trunk	trunk	trunk
向	yonder	turn toward	over there
尚	esteem	still, value highly	esteem
字	character	character	letter
守	guard	protect	protect
完	perfect	complete	perfect
宣	proclaim	proclaim	proclaim
宵	wee hours	early evening	wee hours
安	relax	peaceful, inexpensive	cheap
宴	banquet	banquet	banquet
寄	draw near	contribute, draw near	approach
富	wealth	rich	rich
貯	savings	lay up	savings
木	tree	tree, wood	tree
林	grove	forest	woods
森	forest	thick woods	forest
桂	Japanese Judas tree	aromatic tree	
柏	oak		
枠	frame	frame	frame
梢	treetops	tip of twig	
棚	shelf	shelf	shelf
杏	apricot	apricot	
桐	paulownia	paulownia	
植	plant	plant	plant
枯	wither	wither	wither
朴	crude	simple	crude
村	town	village	village
相	inter-	phase, mutual, minister	mutual
机	desk	desk	desk
本	book	basis, book, this	book
札	tag	tag	tag
暦	calendar	calendar	calendar
案	plan	proposal	plan
燥	parch	dry up	parch
未	not yet	not yet	not yet
末	extremity	last part	end
沫	splash		
味	flavor	taste	flavor
妹	younger sister	younger sister	younger sister
朱	vermillion	vermillion	vermilion
株	stocks	stock	stocks
若	young	young	young
草	grass	grass	grass
苦	suffering	suffering, bitter	suffer
寛	tolerant	lenient	tolerant
薄	dilute	thin	dilute
葉	leaf	leaf	leaf
模	imitation	pattern	imitation
漠	vague	desert, obscure	vague
墓	grave	grave	grave
暮	livelihood	dusk, live	livelihood
膜	membrane	membrane	membrane
苗	seedling	seedling	seedling
兆	portent	omen, trillion	portent, trillion
桃	peach tree	peach	peach tree
眺	stare	look out over	stare
犬	dog	dog	dog
状	status quo	form, condition, letter	form
黙	silence	silent	silence
然	sort of thing	modifier forming suffix, so	so
荻	reed		
狩	hunt	hunt	hunt
猫	cat	cat	cat
牛	cow	cattle	cow
特	special	special	special
告	revelation	notify	to tell
先	before	ahead	previous
洗	wash	wash	wash
介	jammed in	mediate	jammed in
界	world	world, bounds	world
茶	tea	tea	tea
合	fit	combine, fit	fit
塔	pagoda	tower	pagoda
王	king	king	king
玉	jewel	gem	ball
宝	treasure	treasure	treasure
珠	pearl	pearl	pearl
現	present	actual, appear	appear
狂	lunatic	crazy	lunatic
皇	emperor	emperor	emperor
呈	display	present	display
全	whole	whole	whole
栓	plug	stopper	plug
理	logic	reason, basic principal	reason
主	lord	main, master	master
注	pour	pour, concentrate	pour
柱	pillar	pillar	pillar
金	gold	metal, gold, money	gold
銑	pig-iron	pig iron	
鉢	bowl	bowl	bowl
銅	copper	copper	copper
釣	angling	angle	angling
針	needle	needle	needle
銘	inscription	inscription	inscription
鎮	tranquilize	quell	tranquilize
道	road-way	way	road
導	guidance	guide	guide
辻	crossing	crossroads	
迅	swift	swift	swift
造	create	make	create
迫	urge	press	urge
逃	escape	escape	escape
辺	environs	vicinity, borderland	environs
巡	patrol	make the rounds	patrol
車	car	vehicle, wheel	car
連	take along	link, in succession	take along
軌	rut	track	rut
輸	transport	transport	transport
前	in front	before	in front
各	each	each	each
格	status	norm, status	status
略	abbreviation	abridged, strategy	abbreviation
客	guest	visitor, customer	guest
額	forehead	amount	amount
夏	summer	summer	summer
処	dispose	deal with	dispose
条	twig	article	clause
落	fall	fall	fall
冗	superfluous	redundant	superfluous
軍	army	army	army
輝	radiance	shine brilliantly	radiance
運	carry	carry, move, fortune	carry
冠	crown	crown	crown
夢	dream	dream	dream
坑	pit	pit	pit
高	tall	high	tall, expensive
享	receive	enjoy	receive
塾	cram school	private school	cram school
熟	mellow	mature	ripen
亭	pavilion	inn, pseudonym suffix	pavilion
京	capital	capital, Tokyo, Kyoto	capital
涼	refreshing	cool	refreshing
景	scenery	scene	scenery
鯨	whale	whale	whale
舎	cottage	building	cottage
周	circumference	periphery	circumference
週	week	week	week
士	gentleman	military man, profession suffix	gentleman
吉	good luck	lucky	good luck
壮	robust	vigorous, grand	robust
荘	villa	villa, dignified	villa
売	sell	sell	sell
学	study	study, educational institution	study
覚	memorize	perceive, commit to memory	memorize
栄	flourish	flourish, glory	prosperity
書	write	write, book	write
津	haven	harbor	haven
牧	breed	pasture	breed
攻	aggression	attack	aggression
敗	failure	be defeated	failure
枚	sheet of…	counter for flat things	sheet of...
故	happenstance	old, the late	circumstances
敬	awe	respect	respect
言	say	say, speech	say
警	admonish	guard against, warn	guard against
計	plot	plan, compute	measure
獄	prison	prison	prison
訂	revise	revise	revise
討	chastise	study, suppress by armed force	chastise
訓	instruction	instruct	instruction
詔	imperial edict	imperial edict	imperial edict
詰	packed	reprimand, stuff	packed
話	tale	speak	talk
詠	recitation	recite poetry	recitation
詩	poem	poetry	poem
語	word	language, word, tell	language
読	read	read	read
調	tune	tone, investigate, prepare	investigate
談	discuss	talk	discuss
諾	consent	consent	consent
諭	rebuke	admonish	rebuke
式	style	style, ceremony	style
試	test	try	test
弐	II	two	two (falsification prevention)
域	range	bounded area	range
賊	burglar	bandit	burglar
栽	plantation	plant	plantation
載	load	load, put in print	ride
茂	overgrown	grow thick	overgrown
成	turn into	form, achieve	become
城	castle	castle	castle
誠	sincerity	sincerity	sincerity
威	intimidate	might, threaten by force	intimidate
滅	destroy	destroy	destroy
減	dwindle	decrease	decrease
桟	scaffold	plank bridge	scaffold
銭	coin	money	coin
浅	shallow	shallow	shallow
止	stop	stop	stop
歩	walk	walk	walk
渉	ford	have relations with	ford
頻	repeatedly	frequently	repeatedly
肯	agreement	assent	agreement
企	undertake	project	plan
歴	curriculum	personal history	curriculum
武	warrior	military	military
賦	levy	installment	levy
正	correct	right	correct
証	evidence	prove, certificate	evidence
政	politics	political administration	politics
定	determine	fix	decide
錠	lock	lock, pill	lock
走	run	run	run
超	transcend	surpass	transcend
赴	proceed	proceed to	proceed
越	surpass	go beyond	cross over
是	just so	right	just so
題	topic	title, topic, problem	topic
堤	dike	embankment	dike
建	build	build	build
延	prolong	extend, postpone	prolong
誕	nativity	be born	nativity
礎	cornerstone	foundation stone	cornerstone
婿	bridegroom	son-in-law	bridegroom
衣	garment	garment	clothes
裁	tailor	cut out, judge	judge
装	attire	dress, fit out	attire
裏	back	rear	back
壊	demolition	break down	demolition
哀	pathetic	sorrow, pity	pathetic
遠	distant	distant	far
猿	monkey	monkey	monkey
初	first time	first	first
布	linen	cloth, spread	linen
帆	sail	sail	sail
幅	hanging scroll	width	breadth
帽	cap	headgear	cap
幕	curtain	curtain, shogunate	curtain
幌	canopy		
錦	brocade	brocade	brocade
市	market	city, market	market
姉	elder sister	older sister	older sister
肺	lungs	lung	lungs
帯	sash	belt, wear	sash
滞	stagnate	stagnate, stay	stagnate
刺	thorn	stab	thorn
制	system	system, control	control
製	made in…	manufacture	manufacture
転	revolve	turn	revolve
芸	technique	art	art
雨	rain	rain	rain
雲	cloud	cloud	cloud
曇	cloudy weather	cloudy	cloudy weather
雷	thunder	thunder	thunder
霜	frost	frost	frost
冬	winter	winter	winter
天	heavens	heaven	heaven
橋	bridge	bridge	bridge
嬌	attractive		
立	stand up	stand, establish	stand up
泣	cry	cry	cry
章	badge	chapter, badge	chapter
競	vie	compete	compete
帝	sovereign	emperor	sovereign
童	juvenile	child	juvenile
瞳	pupil	pupil	pupil
鐘	bell	bell	bell
商	make a deal	trade	sell
嫡	legitimate wife	legitimate child	legitimate wife
適	suitable	suitable	suitable
滴	drip	drop	drip
敵	enemy	enemy	enemy
匕	spoon		
北	north	north	north
背	stature	back	back
比	compare	compare	compare
昆	descendants	insect	descendants
皆	all	all	all
混	mix	mix	mix
渇	thirst	run dry, thirst	thirst
謁	audience	be granted an audience	audience
褐	brown	brown	brown
喝	hoarse	shout at	hoarse
旨	delicious	purport	delicious
脂	fat	fat	fat
壱	I (one)	one	one (Falsification prevention)
毎	every	every	every
敏	cleverness	nimble	cleverness
梅	plum	Japanese apricot	ume (Japanese apricot)
海	sea	sea	sea
乞	beg		beg
乾	drought	dry	dry
腹	abdomen	belly	abdomen
複	duplicate	compound	duplicate
欠	lack	lack	lack
吹	blow	blow	blow
炊	cook	cook	cook
歌	song	song	song
軟	soft	soft	soft
次	next	next	next
茨	briar		thorn
資	assets	resources	resources
姿	figure	figure	figure
諮	consult with	consult	consult with
賠	compensation	compensate	compensation
培	cultivate	cultivate	cultivate
剖	divide	dissect	divide
音	sound	sound	sound
暗	darkness	dark	dark
韻	rhyme	rhyme	rhyme
識	discriminating	discriminate, knowledge	discriminating
鏡	mirror	mirror, optical instrument	mirror
境	boundary	boundary, situation	boundary
亡	deceased	decease	deceased
盲	blind	blind	blind
妄	delusion	rash	delusion
荒	laid waste	wild	laid waste
望	ambition	hope, look afar	hope
方	direction	direction, way, square	direction
妨	disturb	hinder	disturb
坊	boy	sonny, colloquial person suffix	boy
芳	perfume	fragrant	perfume
肪	obese	animal fat	obese
訪	call on	visit	visit
放	set free	let go	release
激	violent	violent	violent
脱	undress	remove, escape from	undress
説	rumor / explanation	explain, theory	theory
鋭	pointed	sharp	pointed
曽	formerly		formerly
増	increase	increase	increase
贈	presents	present a gift	presents
東	east	east	east
棟	ridgepole	block	ridgepole
凍	frozen	freeze	frozen
妊	pregnancy	become pregnant	pregnancy
廷	courts	court	courts
染	dye	dye	dye
燃	burn	burn	burn
賓	V.I.P.	guest	V.I.P.
歳	year end	year, age suffix	year-end
県	prefecture	prefecture	prefecture
栃	horse chestnut		horse chestnut
地	ground	ground, place	ground
池	pond	pond	pond
虫	insect	insect	insect
蛍	lightning-bug	firefly	lightning-bug
蛇	snake	snake	snake
虹	rainbow	rainbow	rainbow
蝶	butterfly	butterfly	
独	single	alone, Germany	alone
蚕	silkworm	silkworm	silkworm
風	wind	wind, manner	wind
己	self	oneself	self
起	rouse	rise	wake up
妃	queen	princess	queen
改	reformation	reform	reformation
記	scribe	write down	write down
包	wrap	wrap, encompass	wrap
胞	placenta	membranous sac	placenta
砲	cannon	heavy gun	cannon
泡	bubbles	bubble	bubbles
亀	tortoise	turtle	turtle
電	electricity	electricity	electricity
竜	dragon	dragon	dragon
滝	waterfall	waterfall	waterfall
豚	pork	pig	pork
逐	pursue	one by one, drive out	pursue
遂	consummate	accomplish	consummate
家	house	house, family	house
嫁	marry into	wed a man, bride	marry into
豪	overpowering	great man, magnificent	overpowering
腸	intestines	intenstines	intestines
場	location	place	place
湯	hot water	hot water	hot water
羊	sheep	sheep	sheep
美	beauty	beautiful	beauty
洋	ocean	ocean, western	ocean
詳	detailed	detailed	detailed
鮮	fresh	fresh, vivid	fresh
達	accomplished	attain	attain
羨	envious		envy
差	distinction	difference	distinction
着	don	put on, arrive, stick	wear
唯	solely	only	solely
焦	char	scorch, be impatient	char
礁	reef	reef	reef
集	gather	collect	collect
准	quasi-	junior	quasi-
進	advance	advance	advance
雑	miscellaneous	miscellaneous, mixed	miscellaneous
雌	feminine / female	female	feminine
準	semi-	standard, quasi-	standard
奮	stirred up	rouse up	stirred up
奪	rob	rob	rob
確	assurance	certain	certain
午	noon	noon	noon
許	permit	permit	permit
歓	delight	joyous	delight
権	authority	right, power	rights
観	outlook	view	observe
羽	feathers	feather, wing	feather
習	learn	learn, custom	learn
翌	the following	the following	the following
曜	weekday	day of the week	day of the week
濯	laundry	rinse	laundry
曰	sayeth		
困	quandary	be in trouble	become distressed
固	harden	solid, firm	hard
国	country	country	country
団	group	body	group
因	cause	cause	cause
姻	matrimony	marriage	matrimony
園	park	garden	garden
回	times	turn round, time	times
壇	podium	platform	podium
店	store	shop	shop
庫	warehouse	storage chamber	warehouse
庭	courtyard	court, garden	garden
庁	government office	government agency	government office
床	bed	bed, floor	bed
麻	hemp	hemp, become numb	hemp
磨	grind	polish	grind
心	heart	heart	heart
忘	forget	forget	forget
忍	endure	bear	endure
認	acknowledge	recognise	recognize
忌	mourning	mourning, abhor	mourning
志	intention	ambition	intention
誌	document	magazine	document
忠	loyalty	loyalty	loyalty
串	shish kebab		skewer
患	afflicted	affected by disease	afflicted
思	think	think	think
恩	grace	grace, debt of gratitude	grace
応	apply	respond	respond
意	idea	mind, meaning	idea
想	concept	conceive	concept
息	breath	breath	breath
憩	recess	take a rest	recess
恵	favor	favor	favor
恐	fear	fear	fear
惑	beguile	bewildered	beguile
感	emotion	sense, feel	feeling
憂	melancholy	be anxious	melancholy
寡	widow	few	widow
忙	busy	busy	busy
悦	ecstasy	delighted	ecstasy
恒	constancy	constant	constancy
悼	lament	mourn	lament
悟	enlightenment	awake to	enlightenment
怖	dreadful	fearful	dreadful
慌	disconcerted	flurried	disconcerted
悔	repent	repent	repent
憎	hate	hate	hate
慣	accustomed	habitual practice	accustomed
愉	pleasure	pleased	pleasure
惰	lazy	lazy	lazy
慎	humility	prudent	humility
憾	remorse	strongly regret	remorse
憶	recollection	speculate, remember	recollection
慕	pining	adore	pining
添	annexed	add to	annexed
必	invariably	without fail	without fail
泌	ooze	secrete	ooze
手	hand	hand, occupation suffix	hand
看	watch over	watch, care for	watch over
摩	chafe	rub against	chafe
我	ego	self	ego
義	righteousness	righteousness, meaning	righteousness
議	deliberation	discuss, legislative body	deliberation
犠	sacrifice	sacrifice	sacrifice
抹	rub	wipe	rub
抱	embrace	hug	embrace
搭	board	board	board
抄	extract	excerpt	extract
抗	confront	resist	confront
批	criticism	criticize	criticism
招	beckon	invite	beckon
拓	clear the land	open up	clear (the land)
拍	clap	beat	clap
打	strike	strike	hit
拘	arrest	arrest	arrest
捨	discard	discard	throw away
拐	kidnap	kidnap	kidnap
摘	pinch	pick	pinch
挑	challenge	provoke	challenge
指	finger	finger, point	finger
持	hold	hold	hold
括	fasten	lump together	fasten
揮	brandish	wield	brandish
推	conjecture	infer	infer
揚	hoist	raise high, exalt	hoist
提	propose	present	present
損	damage	loss	loss
拾	pick up	pick up	pick up
担	shouldering	bear on shoulder, undertake	shouldering
拠	foothold	grounds	foothold
描	sketch	depict	sketch
操	maneuver	manipulate	maneuver
接	touch	contact	contact
掲	put up (a notice)	put up	put up (a notice)
掛	hang	set, hang	hang
研	polish	grind, research	sharpen
戒	commandment	caution	commandment
械	contraption	mechanical contrivance	contraption
鼻	nose	nose	nose
刑	punish	penalty	punish
型	mould	type	model
才	genius	talent, age suffix	genius
財	property	wealth	wealth
材	lumber	timber, material	lumber
存	suppose	exist	suppose
在	exist	be	exist
乃	from	possessive particle	
携	portable	carry in the hand	portable
及	reach out	reach to 	reach out
吸	suck	suck, breathe in	suck
扱	handle	handle	handle
丈	length	stout, stature	length
史	history	history	history
吏	officer	official	officer
更	grow late	renew	grow late
硬	stiff	hard	stiff
又	or again	again	or again
双	pair	set of two	pair
桑	mulberry	mulberry	mulberry
隻	vessels	one of a pair, counter for ships	vessels
護	safeguard	protect	safeguard
獲	seize	catch game	seize
奴	guy	slave, guy	guy
怒	angry	get angry	angry
友	friend	friend	friend
抜	slip out	pull out, stand out	slip out
投	throw	throw, send in	throw
没	drown	sink	drown
設	establishment	set up	establish
撃	beat	strike	beat
殻	husk	shell	husk
支	branch	branch, support	branch
技	skill	skill	skill
枝	bough	branch	branch
肢	limb	limb	limb
茎	stalk	stem	stalk
怪	suspicious	mysterious	suspicious
軽	lightly	light	light
叔	uncle	younger sibling of parent	uncle
督	coach	supervise, commander	coach
寂	loneliness	lonesome	loneliness
淑	graceful	graceful	graceful
反	anti-	counter	anti-
坂	slope	slope	slope
板	plank	board, plate	board
返	return	return	return
販	marketing	engage in sales	marketing
爪	claw		claw
妥	gentle	come to terms	gentle
乳	milk	milk	milk
浮	floating	float	floating
将	leader	general officer	leader
奨	exhort	encourage	exhort
採	pick	pick, gather	pick
菜	vegetable	vegetable	vegetable
受	accept	receive	accept
授	impart	confer	instruct
愛	love	love	love
払	pay	clear away, pay	pay
広	wide	wide	wide
拡	broaden	enlarge	broaden
鉱	mineral	ore, mine	mineral
弁	valve	speak eloquently, valve	valve
雄	masculine / male	male, heroic	male
台	pedestal	stand, counter for vehicles	pedestal
怠	neglect	remiss	neglect
治	reign	govern, cure	govern
始	commence	begin	begin
胎	womb	fetus, womb	womb
窓	window	window	window
去	gone	go away	leave
法	method	law, method	method
会	meeting	meet, society	association
至	climax	come to 	climax
室	room	room	room
到	arrival	arrive	arrival
致	doth	bring about, do humbly	(to) do
互	mutually	reciprocal	mutually
棄	abandon	abandon	abandon
育	bring up	raise	nurture
撤	remove	withdraw	remove
充	allot	fill	allot
銃	gun	gun	gun
硫	sulphur	sulfur	sulphur
流	current	flow, current, style	stream
允	license	give consent	
唆	tempt	instigate	tempt
出	exit	go out, put out	exit
山	mountain	mountain	mountain
拙	bungling	clumsy	bungling
岩	boulder	rock	boulder
炭	charcoal	coal, charcoal	charcoal
岐	branch off	diverge	branch off
峠	mountain peak / mountain pass	mountain pass	mountain peak
崩	crumble	crumble	crumble
密	secrecy	close, secret	secrecy
蜜	honey		honey
嵐	storm	storm	storm
崎	promontory	promontory	promontory
入	enter	enter, put in	enter
込	crowded	move inward, emphatic verbal suffix	crowded
分	part	divide, part, minute	minute
貧	poverty	poor	poor
頒	partition	distribute widely	partition
公	public	public	public
松	pine tree	pine	pine
翁	venerable old man	old man	venerable old man
訟	sue	litigate	sue
谷	valley	valley	valley
浴	bathe	bathe	bathe
容	contain	appearance, contain	contain
溶	melt	dissolve, melt	melt
欲	longing	desire	longing
裕	abundant	abundant	abundant
鉛	lead	lead	lead
沿	run alongside	along	run alongside
賞	prize	prize	prize
党	party	party	group
堂	public chamber / hall	hall	public chamber
常	usual	normal, regular	normal
裳	skirt		
掌	manipulate	palm, take charge of	manipulate
皮	pelt	skin	skin
波	waves	wave	wave
婆	old woman	old woman	old woman
披	expose	open out	expose
破	rend	break	rend
被	incur	be subjected to	incur
残	remainder	remain, ruthless	remainder
殉	martyrdom	die a martyr	martyrdom
殊	particularly	special	particularly
殖	augment	multiply	augment
列	file	row	row
裂	split	split	split
烈	ardent	vehement	ardent
死	death	die	death
葬	interment	funeral	interment
瞬	wink	instant	wink
耳	ear	ear	ear
取	take	take	take
趣	gist	flavor, purpose	gist
最	utmost	most	most
撮	snapshot	photograph	snapshot
恥	shame	shame	shame
職	post	employment	employment
聖	holy	holy, saint	holy
敢	daring	boldly	daring
聴	listen	listen	listen
懐	pocket	bosom, long for	pocket
慢	ridicule	arrogant, sluggish	ridicule
漫	loose	rambling, comic	cartoon
買	buy	buy	buy
置	placement	place	put
罰	penalty	punishment	penalty
寧	rather	courteous	rather
濁	voiced	turbid	voiced
環	ring	ring, surround	ring
還	send back	return	send back
夫	husband	husband, man laborer	husband
扶	aid	lend support to	aid
渓	mountain stream	ravine	mountain stream
規	standard	regulation	rule
替	exchange	replace	exchange
賛	approve	approve of, praise	approve
潜	submerge	submerge, lurk	submerge
失	lose	lose, slip	lose
鉄	iron	iron	iron
迭	transfer / alternate	alternate	transfer
臣	retainer	retainer	retainer
姫	princess	daughter of noble birth	princess
蔵	storehouse	store	warehouse
臓	entrails	internal organ	entrails
賢	intelligent	wise	intelligent
堅	strict	firm	strict
臨	look to	be present at	look to
覧	perusal	look over	perusal
巨	gigantic	huge	gigantic
拒	repel	refuse	repel
力	power	power	power
男	male / man	man	male
労	labor	labor	labour
募	recruit	raise	recruit
劣	inferiority	inferior	inferiority
功	achievement	merit	achievement
勧	persuade	urge	persuade
努	toil	exert	toil
励	encourage	encourage	encourage
加	add	add	add
賀	congratulations	congratulate	congratulations
架	erect	lay across	rack
脇	armpit		aside
脅	threaten	threaten	threaten
協	co-	cooperate	cooperation
行	going	go, act, line	go
律	rhythm	law, rhythm	law
復	restore	return to	again
得	gain	acquire, gain	acquire
従	accompany	follow	obey
徒	junior	follower	junior
待	wait	wait	wait
往	journey	go on	outward journey
征	subjugate	conquer	subjugate
径	diameter	path, diameter	diameter
彼	he	third person pronoun	he
役	duty	service	service
徳	benevolence	virtue	benevolence
徹	penetrate	go through	penetrate
徴	indications	levy, symptom	indications
懲	penal	chastise	penal
微	delicate	slight	delicate
街	boulevard	city quarter	street
衡	equilibrium	balance	equilibrium
稿	draft	manuscript	draft
稼	earnings	work	earnings
程	extent	extent, established form	extent
税	tax	tax	tax
稚	immature	childish	immature
和	harmony	harmonious, peace, Japan	peace
移	shift	shift	shift
秒	second	second	second (part of time)
秋	autumn	autumn	autumn
愁	distress	melancholy	distress
私	private	private, I	me
秩	regularity	order	regularity
秘	secret	secret	secret
称	appellation	appellation	appellation
利	profit	advantage, profit	profit
梨	pear tree	pear	pear tree
穫	harvest	harvest	harvest
穂	ear (of a plant)	spike	ear
稲	rice plant	rice plant	rice plant
香	incense	sweet smell	incense
季	seasons	season	seasons
委	committee	commit	committee
秀	excel	excellent	excel
透	transparent	pass through, transparent	transparent
誘	entice	induce	entice
穀	cereals	cereal	cereals
菌	germ	bacteria	germ
米	rice	rice, America	rice
粉	flour	powder	flour
粘	sticky	sticky	sticky
粒	grains	grain	grains
粧	cosmetics	apply makeup	cosmetics
迷	astray	perplexed	astray
粋	chic	refined	chic
糧	provisions	food provisions	provisions
菊	chrysanthemum	chrysanthemum	chrysanthemum
奥	core	inner part	heart
数	number	number	number
楼	watchtower	tall building	watchtower
類	sort	kind	sort
漆	lacquer	lacquer	lacquer
様	Esq.	mode, formal title	formal title
求	request	seek	request
球	ball	ball	sphere
救	salvation	save	salvation
竹	bamboo	bamboo	bamboo
笑	laugh	laugh	laugh
笠	bamboo hat		
笹	bamboo grass	bamboo grass	
筋	muscle	muscle, threadlike structure	muscle
箱	box 	box	box
筆	writing brush	brush, writing	writing brush
筒	cylinder	tube	cylinder
等	etc.	equal, class	class
算	calculate	calculate	calculate
答	solution	answer	answer
策	scheme	scheme, measure	scheme
簿	register	record book	register
築	fabricate	construct	fabricate
人	person	human being	person
佐	assistant	assist, field officer	help
但	however	provided that	however
住	dwell	live	dwelling
位	rank	rank	rank
仲	go-between	intermediary, personal relations	relationship
体	body	body, form	body
悠	permanence / remote	leisurely	permanence
件	affair	matter	affair
仕	attend	serve, do	do
他	other	other	other
伏	prostrated	prostrated	prostrated
伝	transmit	transmit	transmit
仏	buddha	buddha, France	Buddha
休	rest	rest	rest
仮	sham / provisional	temporary	temporary
伯	chief	older sibling of parent, chief	chief
俗	vulgar	popular	vulgar
信	faith	believe,  message	trust
佳	excellent	fine	excellent
依	reliant	depend on	reliant
例	example	example	example
個	individual	individual, general counter	individual
健	healthy	robust	healthy
側	side	side	side
侍	waiter	attend upon,  samurai	waiter
停	halt	halt	halt
値	price	value	value
倣	emulate	copy after	emulate
倒	overthrow	topple	overthrow
偵	spy	spy	spy
僧	buddhist priest	bonze	Buddhist priest
億	hundred million	hundred million	hundred million
儀	ceremony	ceremony	ceremony
償	reparation	recompense	reparation
仙	hermit	immortal mountain fairy	hermit
催	sponsor	hold an event, press for	sponsor
仁	humanity	benevolence	humanity
侮	scorn	insult	scorn
使	use	use,   envoy	use
便	convenience	convenient,  post,  excreta	convenience
倍	double	times, double	double
優	tenderness	superior, actor	superior
伐	fell	cut down	fell
宿	inn	lodge	inn
傷	wound	wound	wound
保	protect	preserve	preserve
褒	praise	commend	praise
傑	greatness	outstanding person	greatness
付	adhere	attach	attach
符	token	symbol	token
府	borough / municipality	urban prefecture	urban prefecture
任	responsibility	office, leave to	responsibility
賃	fare	wage, charges	fare
代	substitute	substitute, generation, charge	substitute
袋	sack	bag	sack
貸	lend	lend	lend
化	change	change into	change
花	flower	flower	flower
貨	freight	money, goods	freight
傾	lean	incline	lean
何	what	what, how many	what
荷	baggage	load	luggage
俊	sagacious	brilliant person	genius
傍	bystander	beside	bystander
久	long time	of long duration	long time
畝	furrow	se	furrow
囚	captured	prisoner	captured
内	inside	inside	inside
丙	third class	third	third class
柄	design	character, handle	design
肉	meat	flesh	meat
腐	rot	rot	rot
座	squat / sit	seat, sit	sit
卒	graduate	graduate	graduate
傘	umbrella	umbrella	umbrella
匁	monme	monme	
以	by means of	to the…of, by means of	by means of
似	becoming / similar	resemble	becoming
併	join	together	join
瓦	tile		tile
瓶	flower pot	bottle	flower pot
宮	shinto shrine	royal palace, shinto shrine	Shinto shrine
営	occupation	manage, barracks	manage
善	virtuous	good	good
年	year	year	year
夜	night	night	night
液	fluid	liquid	fluid
塚	hillock	mound	hillock
幣	cash	currency	cash
弊	abuse	evil practice	abuse
喚	yell	call	yell
換	interchange	exchange	interchange
融	dissolve	fuse	dissolve
施	alms	carry out	carry out
旋	rotation	gyrate	rotation
遊	play	play	play
旅	trip	travel	trip
勿	not		
物	thing	thing	thing
易	easy	easy, exchange	easy
賜	grant	deign to give	grant
尿	urine	urine	urine
尼	nun	buddhist nun	nun
泥	mud	mud	mud
塀	fence	fence	fence
履	footgear	fulfill	footgear
屋	roof	house, small shop	roof
握	grip	grasp	grip
屈	yield	bend	yield
掘	dig	dig	dig
堀	ditch  (moat)	ditch	ditch
居	reside	reside	reside
据	set	install	set
層	stratum	stratum	stratum
局	bureau	bureau, limited part	office
遅	slow	slow, late	slow
漏	leak	leak	leak
刷	printing	print	printing
尺	shaku	shaku	shaku
尽	exhaust	exhaust	exhaust
沢	swamp	marsh	swamp
訳	translate	translate, sense	translate
択	choose	select	choose
昼	daytime	daytime	daytime
戸	door	door, household	door
肩	shoulder	shoulder	shoulder
房	tassel	chamber	tassel
扇	fan	fan	fan
炉	hearth	furnace	hearth
戻	re-	return	re-
涙	tears	tear	tears
雇	employ	employ	employ
顧	look back	look back	look back
啓	disclose	enlighten	disclose
示	show	show	indicate
礼	salute / salutation	etiquette, rite	thanks
祥	auspicious	auspicious	auspicious
祝	celebrate	celebrate	celebrate
福	blessing	fortune	luck
祉	welfare	blessedness	welfare
社	company	company, society	company
視	inspection	regard	look at
奈	nara	phonetic (na)	what
尉	military officer	company officer	military officer
慰	consolation	console	consolation
款	goodwill	article	goodwill
禁	prohibition	prohibit	prohibition
襟	collar	collar	collar
宗	religion	religious sect	religion
崇	adore	reverence	adore
祭	ritual	festival	festival
察	guess	inspect, guess	guess
擦	grate	rub	grate
由	wherefore	reason	reason
抽	pluck	draw out	pluck
油	oil	oil	oil
袖	sleeve	sleeve	sleeve
宙	mid-air	space, midair	mid-air
届	deliver	deliver, reach	deliver
笛	flute	flute	flute
軸	axis	axle, axis	axis
甲	armor	shell, first	armor
押	push	push	push
岬	headland	cape	headland
挿	insert	insert	insert
申	speaketh	report, speak humbly	say
伸	expand	stretch	to lengthen
神	gods	god, mind	god
捜	search	look for	search
果	fruit	fruit	fruit
菓	candy / confectionary	confectionery	confectionery
課	chapter	section, lesson	section
裸	naked	naked	naked
斤	axe	catty	axe
析	chop	analyze	chop
所	place	place, particle of nominalization	place
祈	pray	pray	pray
近	near	near, recent	near
折	fold	break off, fold	fold
哲	philosophy	sagacious, philosophy	philosophy
逝	departed	depart this life	departed
誓	vow	vow	vow
暫	temporarily	short while	temporarily
漸	steadily	gradually	steadily
断	severance	cut off, resolve	cut off
質	substance	quality, matter	quality
斥	reject	expel	reject
訴	accusation	appeal to, sue	sue
昨	yesterday	yesterday, last	previous
詐	lie	swindle	lie
作	make	make, work	make
雪	snow	snow	snow
録	record	record	record
尋	inquire	inquire	inquire
急	hurry	urgent, hurry, sudden	hurry
穏	calm	calm, mild	calm
侵	encroach	invade	encroach
浸	immersed	soak	immersed
寝	lie down	go to sleep	lie down
婦	lady	adult woman	lady
掃	sweep	sweep	sweep
当	hit	the present, hit	hit
争	contend	contend	conflict
浄	clean	clean	clean
事	matter	affair, abstract thing	abstract thing
唐	T’ang	Tang dynasty	T'ang
糖	sugar	sugar	sugar
康	ease / sane	healthy	health
逮	apprehend	catch a criminal	apprehend
伊	italy	phonetic i, Italy	
君	old boy	ruler, familiar title, you	you
群	flock	group	flock
耐	proof	withstand	resistant
需	demand	demand	demand
儒	confucian	confucianism	Confucian
端	edge	end	edge
両	both	both	both
満	full	full	full
画	brush-stroke	picture, draw up a plan	tableau
歯	tooth	tooth	tooth
曲	bend	musical composition, curve	musical composition
曹	cadet	sergeant	cadet
遭	encounter	meet with	encounter
漕	rowing		
槽	vat	tank	vat
斗	big dipper	dipper, to	Big Dipper
料	fee	fee, materials	fee
科	department	subject of study	section
図	map	drawing	diagram
用	utilize	employ, things to do	use
庸	commonplace / comfortable	mediocre	commonplace
備	equip	provide	provide
昔	once upon a time	former times	long ago
錯	confused	mixed up	confused
借	borrow	borrow	borrow
惜	pity	regret	pity
措	set aside	dispose	set aside
散	scatter	scatter	scatter
廿	twenty		
庶	commoner	manifold	commoner
遮	intercept	interrupt	intercept
席	seat	seat	seat
度	degrees	degree, time	degrees
渡	transit	cross	transit
奔	bustle	rush	bustle
噴	erupt	spout	erupt
墳	tomb	tumulus	tomb
憤	aroused	indignation	aroused
焼	bake	burn	bake
暁	daybreak	dawn	daybreak
半	half	half	half
伴	consort	accompany	consort
畔	paddy-ridge	waterside	paddy-ridge
判	judgement	judge	judge
券	ticket	ticket, certificate	ticket
巻	scroll	roll up, volume	scroll
圏	sphere	sphere	sphere
勝	victory	win, excel	win
藤	wisteria	wisteria	wisteria
謄	mimeograph / facsimile	transcribe	mimeograph
片	one-sided	fragment, one of two	one-sided
版	printing block	printing plate, publishing	printing block
之	of	possessive particle	
乏	destitution	scanty	scarce
芝	turf	lawn grass	turf
不	negative	not	non-
否	negate	say no, or not	negate
杯	cupfuls	cup	counter for cupfuls
矢	dart	arrow	arrow
矯	rectify	rectify	rectify
族	tribe	family	tribe
知	know	know	know
智	wisdom	wisdom	
矛	halberd	halberd	halberd
柔	tender	soft	tender
務	task	duty	duty
霧	fog	fog	fog
班	squad	squad	squad
帰	homecoming	return	to return
弓	bow	bow	bow (archery, violin)
引	pull	draw	pull
弔	condolences	condole	condolences
弘	vast	disseminate	
強	strong	strong	strong
弱	weak	weak	weak
沸	seethe	boil	seethe
費	expense	expense	expense
第	no.	ordinal number prefix	ordinal number prefix
弟	younger brother	younger brother	younger brother
巧	adroit	skillful	adroit
号	nickname	number, designation, sign	number
朽	decay	decay	decay
誇	boast	boast	boast
汚	dirty	dirty	dirty
与	bestow	give	give
写	copy	copy	copy
身	somebody	body, one’s person	body
射	shoot	shoot	shoot
謝	apologize	thank, apologise	apologize
老	old man	old	old man
考	consider	think	think
孝	filial piety	filial piety	filial piety
教	teach	teach, religion	teach
拷	torture	torture	torture
者	someone	person	someone
煮	boil	boil	boil
著	renowned	author, conspicuous	renowned
署	signature	public-service station	government office
暑	sultry	summer heat, hot	hot
諸	various	various	various
猪	boar	wild boar	
渚	strand	strand	
賭	gamble		gamble
峡	gorge	gorge	gorge
狭	cramped	narrow	cramped
挟	sandwiched	hold between	pinch
追	chase	chase	follow
師	expert	master	expert
帥	commander	commander in chief	commander
官	bureaucrat	government, government official	government official
棺	coffin	coffin	coffin
管	pipe	pipe, exercise control	pipe
父	father	father	father
交	mingle	intercourse, interchange	mix
効	merit	effect	effect
較	contrast	compare	contrast
校	exam	school, collate	school
足	leg	foot, suffice	foot
促	stimulate	hasten	stimulate
距	long-distance	distance	long-distance
路	path	road	road
露	dew	dew, expose	dew
跳	hop	jump	hop
躍	leap	leap	leap
践	tread	implement	tread
踏	step	tread	step
骨	skeleton	bone	bone
滑	slippery	slide, smooth	slippery
髄	marrow	marrow	marrow
禍	calamity	calamity	calamity
渦	whirlpool	whirlpool	whirlpool
過	overdo	pass by, exceed	go beyond
阪	heights	osaka	heights
阿	africa	phonetic (a)	
際	occasion	verge, occasion	occasion
障	hinder	hindrance	hurt
随	follow	follow	follow
陪	obeisance / auxiliary	accompany a superior	obeisance
陽	sunshine	sun	sunshine
陳	exhibit / line up	set forth	exhibit
防	ward off	prevent	prevent
附	affixed	attach	affixed
院	Inst.	institution	institution
陣	camp	battle formation, camp	camp
隊	regiment	party	group
墜	crash	drop down	crash
降	descend	descend	descend
階	storey	floor, rank	floor of a building
陛	highness	imperial palace steps	highness
隣	neighbouring	neighbor	neighboring
隔	isolate	apart	isolate
隠	conceal	hide	conceal
堕	degenerate	degenerate	degenerate
陥	collapse	fall in	collapse
穴	hole	hole	hole
空	empty	sky, air, empty	sky
控	withdraw	hold back	withdraw
突	stab	dash, thrust	stab
究	research	study exhaustively	research
窒	plug up	choke, nitrogen	plug up
窃	stealth	steal	stealth
窪	depression		
搾	squeeze	squeeze	squeeze
窯	kiln	kiln	kiln
窮	hard up	be in extremity	hard up
探	grope	probe, search	grope
深	deep	deep	deep
丘	hill	hill	hill
岳	point	high mountain	point
兵	soldier	soldier	soldier
浜	seacoast	beach	seacoast
糸	thread	thread	thread
織	weave	weave	weave
繕	darning	mend	darning
縮	shrink	shrink	shrink
繁	luxuriant	thrive	luxuriant
縦	vertical	vertical	vertical
線	line	line	line
締	tighten	conclude, tighten	tighten
維	fiber	fiber	fiber
羅	gauze	phonetic (ra)	gauze
練	practice	train	practice
緒	thong	outset	thong
続	continue	continue	continue
絵	picture	picture	picture
統	overall	unite, interconnected system	unite
絞	strangle	strangle, wring	strangle
給	salary	supply, pay	salary
絡	entwine	interlink, entwine	entwine
結	tie	tie, conclude	tie
終	end	end	end
級	class	grade	rank
紀	chronicle	era	chronicle
紅	crimson	crimson	deep red
納	settlement	pay, accept, put away	settlement
紡	spinning	spin	spinning
紛	distract	confused	distract
紹	introduce	introduce	introduce
経	sutra	pass through, manage	manage
紳	sire	gentleman	sire
約	promise	promise, contract, approximately	promise
細	dainty	slender, minute	thin
累	accumulate	cumulate	accumulate
索	cord	search for	cord
総	general	total, general	whole
綿	cotton	cotton	cotton
絹	silk	silk	silk
繰	winding	reel, shift onward	winding
継	inherit	succeed	inherit
緑	green	green	green
縁	affinity	relation, edge	affinity
網	netting	net	netting
緊	tense	tighten, exigent	tense
紫	purple	purple	purple
縛	truss	bind	truss
縄	straw rope	rope	straw rope
幼	infancy	very young	infancy
後	behind	after	behind
幽	seclude / faint	quiet and secluded	seclude
幾	how many	how many, some	how many
機	mechanism	machine, aircraft, opportunity	machine
玄	mysterious	profound	mysterious
畜	livestock	livestock	livestock
蓄	amass	store up	amass
弦	bowstring	string	bowstring
擁	hug	support	embrace
滋	nourishing	nourish	nourishing
慈	mercy	affectionate	mercy
磁	magnet	magnetism	magnet
系	lineage	system, lineage	lineage
係	person in charge	connect,  person in charge	person in charge
孫	grandchild	grandchild	grandchild
懸	suspend	suspend	suspend
却	instead	eliminate	instead
脚	skids / shins	leg	leg
卸	wholesale	wholesale	wholesale
御	honorable	general honorific term	honorable
服	clothing	clothes, submit	clothes
命	fate	order, life	fate
令	orders	command	orders
零	zero	zero	zero
齢	age	age	age
冷	cool	cold	cool
領	jurisdiction	territory	territory
鈴	small bell	bell	small bell
勇	courage	brave	courage
通	traffic	pass, communicate	pass through
踊	jump	dance	jump
疑	doubt	doubt	doubt
擬	mimic	imitate	mimic
凝	congeal	congeal	congeal
範	pattern	model	pattern
犯	crime	offense	crime
厄	unlucky	misfortune	unlucky
危	dangerous	dangerous	dangerous
宛	address	address	allocate
腕	arm	arm	arm
苑	garden	imperial garden	
怨	grudge		grudge
柳	willow	willow	willow
卵	egg	egg	egg
留	detain	keep, stay	detain
貿	trade	trade	trade
印	stamp	mark, seal	mark
興	entertain	rise to prosperity, amusement	entertain
酉	sign of the bird	the bird	
酒	sake	alcoholic drink	alcoholic drink
酌	bartending	pour wine	bartending
酵	fermentation	ferment	fermentation
酷	cruel	severe	cruel
酬	repay	reciprocate	repay
酪	dairy products	dairy products	dairy products
酢	vinegar	vinegar	vinegar
酔	drunk	become intoxicated	drunk
配	distribute	distribute	distribute
酸	acid	acid, oxygen	acid
猶	furthermore / waver	delay	furthermore
尊	revered	honor	revered
豆	beans	bean	beans
頭	head	head	head
短	short	short	short
豊	bountiful	plentiful	bountiful
鼓	drum	drum	drum
喜	rejoice	happy	rejoice
樹	timber-trees	standing tree	trees
皿	dish	plate	dish
血	blood	blood	blood
盆	basin	tray, bon festival	basin
盟	alliance	alliance	alliance
盗	steal	steal	steal
温	warm	warm	warm
監	oversee	oversee	oversee
濫	overflow	excessive	excessive
鑑	specimen	appraise, reference volume	specimen
猛	fierce	fierce	fierce
盛	boom	prosperous	prosper
塩	salt	salt	salt
銀	silver	silver	silver
恨	regret / resentment	hold a grudge	rancor
根	root	root	root
即	instant	immediate	instant
爵	baron	rank of nobility	baron
節	node	joint, season of the year	node
退	retreat	retreat	retreat
限	limit	limit	limit
眼	eyeball	eye	eyeball
良	good	good	good
朗	melodious	cheerful, clear	melodious
浪	wandering	billow, wander	wandering
娘	daughter	daughter, girl	daughter
食	eat	eat, food	eat, meal
飯	meal	cooked rice, meal	meal
飲	drink	drink	drink
飢	hungry	starve	hungry
餓	starve	starved	starve
飾	decorate	decorate	decorate
館	bldg.	public building	public building
養	foster	foster	foster
飽	sated	satiated	sated
既	previously	already	previously
概	outline	general	outline
慨	rue	deplore	rue
平	even	flat, calm	flat
呼	call	call	call
坪	two-mat area	tsubo	two-mat area
評	evaluate	comment	evaluate
刈	reap	clip	reap
希	hope	rare, aspire	hope
凶	villain	bad luck, atrocious	villain
胸	bosom	chest	bosom
離	detach	separate	detach
殺	kill	kill	kill
純	genuine	pure	genuine
鈍	dull	dull	dull
辛	spicy	pungent, hard	spicy
辞	resign	word, resign	resign
梓	catalpa	catalpa	
宰	superintend	preside	superintend
壁	wall	wall	wall
避	evade	avoid	evade
新	new	new	new
薪	fuel / firewood	firewood	fuel
親	parent	parents, relatives, intimate	parent
幸	happiness	good fortune, happiness	happiness
執	tenacious	execute, seize	tenacious
報	report	inform, requite	report
叫	shout	shout	shout
糾	twist	inquire into	twist
収	income	take in	take in
卑	lowly	mean	lowly
碑	tombstone	monument	tombstone
陸	land	land	land
睦	intimate	friendly	harmonious
勢	forces	power	power
熱	heat	heat, hot	heat
菱	diamond		
陵	mausoleum	imperial mausoleum	mausoleum
亥	sign of the hog	the boar	
核	nucleus	nucleus	nucleus
刻	engrave	engrave, point of time	engrave
該	above-stated	correspond to	above-stated
劾	censure	expose crimes	censure
述	mention	state	mention
術	art	practical art	art
寒	cold	cold	cold
醸	brew	brew	brew
譲	defer	cede	defer
壌	lot	arable soil	lot
嬢	lass	young lady	lass
毒	poison	poison	poison
素	elementary	element, plain	elementary
麦	barley	wheat	wheat
青	blue	blue, green	blue
精	refined	refine, essence, spirit	refined
請	solicit	request	solicit
情	feelings	emotion, actual conditions	feelings
晴	clear up	fine weather	clear up
清	pure	clear	pure
静	quiet	quiet	quiet
責	blame	responsibility, blame	blame
績	exploits	achievements 	exploits
積	volume	accumulate	accumulate
債	bond	debt, bond	bond
漬	pickling	pickle	pickling
表	surface	express, surface, table	express
俵	bag	straw sack	bag
潔	undefiled	immaculate	undefiled
契	pledge	make an agreement	pledge
喫	consume	injest	consume
害	harm	harm	harm
轄	control	exercise jurisdiction over	control
割	proportion	divide	divide
憲	constitution	constitution	constitution
生	life	life, be born, student	life
星	star	star	star
姓	surname	surname	surname
性	sex	nature, sex, -ity	gender
牲	animal sacrifice	sacrifice	animal sacrifice
産	products	give birth, produce	give birth
隆	hump	prosper	hump
峰	summit	peak	summit
縫	sew	sew	sew
拝	worship	worship, humbly	worship
寿	longevity	longevity, congratulations	longevity
鋳	casting	cast	casting
籍	enroll	register	enroll
春	springtime	spring	springtime
椿	camellia		
泰	peaceful	tranquil	peaceful
奏	play music	play music	play music
実	reality	real	truth
奉	observance / dedicate	dedicate	observance
俸	stipend	salary	salary
棒	rod	rod	rod
謹	discreet	respectfully	discreet
勤	diligence	service	diligence
漢	sino	Chinese, fellow	China
嘆	sigh	sigh	sigh
難	difficult	difficult, disaster	difficult
華	splendor	magnificent, China	splendor
垂	droop	hang down	droop
睡	drowsy	sleep	drowsy
錘	spindle	spindle	
乗	ride	ride, get on	ride
剰	surplus	surplus	surplus
今	now	present, this	now
含	include	contain	include
吟	versify	recite	versify
念	wish	thoughts	thought
琴	harp	koto	harp
陰	shade	shade	shade
予	beforehand	in advance	in advance
序	preface	introductory part, order	preface
預	deposit	deposit	deposit
野	plains	field	field
兼	concurrently	concurrently	concurrently
嫌	dislike	dislike	dislike
鎌	sickle	sickle	sickle
謙	self-effacing	humble	self-effacing
廉	bargain	incorrupt, cheap	bargain
西	West	west	west
価	value	price, value	value
要	need	important, summarize, require	need
腰	loins	waist	loins
票	ballot	vote, slip	ballot
漂	drift	drift	drift
標	signpost	mark	signpost
栗	chestnut	chestnut	
遷	transition	transfer	transition
覆	capsize	cover, overturn	capsize
煙	smoke	smoke	smoke
南	south	south	south
楠	camphor tree	camphor tree	
献	offering	offer	offering
門	gates	gate	gates
問	question	question	question
閲	review	review	review
閥	clique	clique	clique
間	interval	interval, between	interval
簡	simplicity	simple	simplicity
開	open	open	open
閉	closed	close	closed
閣	tower	tall magnificent building, cabinet	tall
閑	leisure	leisure, quiet	leisure
聞	hear	hear	hear
潤	wet	moist	wet
欄	column	column	column
闘	fight	fight	fight
倉	godown	storehouse	warehouse
創	genesis	create	create
非	un-	is not	negative
俳	haiku	haiku	haiku
排	repudiate	exclude, discharge	repudiate
悲	sad	sad	sad
罪	guilt	crime	guilt
輩	comrade	fellow	comrade
扉	front door	hinged door	front door
侯	marquis	feudal lord	marquis
候	climate	season, seasonal weather	climate
決	decide	decide	decide
快	cheerful	pleasant	cheerful
偉	admirable	great	admirable
違	difference	differ, violate	differ
緯	horizontal	latitude	horizontal
衛	defence	guard	defense
韓	korea	South Korea	Korea
干	dry	dry	dry
肝	liver	liver	liver
刊	publish	publish	publish
汗	sweat	sweat	sweat
軒	flats	eaves, counter for houses	flats
岸	beach	shore	beach
幹	tree trunk	trunk	tree-trunk
芋	potato	potato	potato
宇	eaves	universe	eaves
余	too much	remaining, excess	leave over
除	exclude	rid of	exclude
徐	gradually	slowly	gradually
叙	confer	describe	confer
途	route	way	route
斜	diagonal	oblique	diagonal
塗	paint	apply on a surface	paint
束	bundle	tie up, bundle	bundle
頼	trust	rely on, ask	trust
瀬	rapids	shallows	rapids
勅	imperial order	imperial decree	imperial order
疎	alienate	sparse, estrange	alienate
速	quick	quick	fast
整	organise	put in order	put in order
剣	sabre / saber	sword	sabre
険	precipitous	danger, steep	precipitous
検	examination	examine	examine
倹	frugal	frugal	frugal
重	heavy	heavy, duplicate	heavy
動	move	move	move
勲	meritorious deed	meritorious service	meritorious deed
働	work	work	work
種	species	variety, seed	kind
衝	collide	collide	collide
薫	fragrant	balmy	fragrant
病	ill	illness	sick
痴	stupid	stupid	stupid
痘	pox	smallpox	pox
症	symptoms	pathological condition	symptoms
疾	rapidly	disease	rapidly
痢	diarrhea	diarrhea	diarrhea
疲	exhausted / tired	tired	exhausted
疫	epidemic	epidemic	epidemic
痛	pain	pain	pain
癖	mannerism	habit	mannerism
匿	hide	conceal	hide
匠	artisan	craftsman	artisan
医	doctor	medicine, doctor	medicine
匹	equal	counter for animals	equal
区	ward	distict, ward	ward
枢	hinge	pivot	hinge
殴	assault	beat	assault
欧	europe	Europe	Europe
抑	repress	suppress	repress
仰	face up	look up	face-up
迎	welcome	welcome	welcome
登	ascend	climb	climb
澄	lucidity	limpid	lucidity
発	discharge	start, emit	departure
廃	abolish	abolish, waste	abolish
僚	colleague	colleague	colleague
寮	dormitory	dormitory	dormitory
療	heal	treat	heal
彫	carve	carve	carve
形	shape	shape	shape
影	shadow	shadow	shadow
杉	cedar	cryptomeria	cedar
彩	coloring	beautiful coloring	coloring
彰	patent	proclaim merits	patent
彦	lad	male name element	
顔	face	face	face
須	ought	must	by all means
膨	swell	expand	swell
参	nonplussed / visit	participate, visit a holy place	participate
惨	wretched	miserable, cruel	wretched
修	discipline	cultivate, repair	discipline
珍	rare	rare	rare
診	check up	examine a patient	checkup
文	sentence	letter, writings	writing
対	vis-a-vis	opposite, oppose	opposite
紋	family crest	crest	family crest
蚊	mosquito	mosquito	mosquito
斉	adjusted	uniform	adjusted
剤	dose	preparation	dose
済	finish	settle, relieve	settle
斎	purification	observe religious abstinance	purification
粛	solemn	purge	solemn
塁	bases	base, small fort	bases
楽	music	pleasure, comfortable, music	pleasure
薬	medicine	drug	medicine
率	ratio	rate, lead	rate
渋	astringent	no go smoothly, astringent	astringent
摂	vicarious	take in, act as regent	vicarious
央	center	center	center
英	England	distinguished, England	England
映	reflect	reflect, project	reflect
赤	red	red	red
赦	pardon	amnesty	pardon
変	unusual	change, abnormal	change
跡	tracks	trace	tracks
蛮	barbarian	barbarian	barbarian
恋	romance	love	romance
湾	gulf	bay	gulf
黄	yellow	yellow	yellow
横	sideways	sideways	side
把	grasp	grip	grasp
色	color	color	color
絶	discontinue	break off, come to an end	discontinue
艶	glossy	charming, romance	glossy
肥	fertilizer	fatten	fertilizer
甘	sweet	sweet	sweet
紺	navy blue	dark blue	dark blue
某	so and so	a certain	so-and-so
謀	conspire	scheme	conspire
媒	mediator	intermediate	mediator
欺	deceit	deceive	deceit
棋	chess piece	shogi	chess piece
旗	national flag	flag	national flag
期	period	term, expect	period of time
碁	Go game	Go game	Go game
基	fundamentals	base	foundation
甚	tremendously	extremely	tremendously
勘	intuition	check, intuitive perception	intuition
堪	withstand	endure	withstand
貴	precious	noble, your honorable	precious
遺	bequeath	leave behind	bequeath
遣	dispatch	dispatch	dispatch
舞	dance	dance	dance
無	nothingness	without, nothing	nothing
組	association	organize, assemble	association
粗	coarse	coarse	coarse
租	tariff	land tax	tariff
祖	ancestor	ancestor	ancestor
阻	thwart	obstruct	thwart
査	investigate	look into	investigate
助	help	help	help
宜	best regards	right	best regards
畳	tatami mat	tatami, fold up	tatami mat
並	row	line up	line-up
普	universal	widespread	universal
譜	musical score	systematic record	musical score
湿	damp	damp	damp
顕	appear	manifest	appear
繊	slender	fine, fiber	slender
霊	spirits	spirit	spirits
業	business / profession	work, business, industry	business
撲	slap	deal a blow	slap
僕	me	I, manservant	me
共	together	joint	together
供	submit	offer	offer
異	uncommon	different	uncommon
翼	wing	wing	wing
洪	deluge	flood	deluge
港	harbor	port	harbor
暴	outburst	violent	outburst
爆	bomb	explode	explode
恭	respect	respectful	respect
選	elect	choose	choose
殿	Mr	palace, formal honorific title	Mr.
井	well	well	well
囲	surround	enclose	surround
耕	till	till	till
亜	Asia	sub-, phonetic (a)	sub-
悪	bad	bad	bad
円	circle	circle, yen	round, yen
角	angle	angle, horn	angle
触	contact	touch	contact
解	unravel	take apart, dissolve, clarify	untie
再	again	another time	again
講	lecture	lecture	lecture
購	subscription	purchase	subscription
構	posture	constuct, mind	construct
溝	gutter	channel	gutter
論	argument	argue, theory	theory
倫	ethics	morals	ethics
輪	wheel	wheel, ring	wheel
偏	partial	one-sided	partial
遍	everywhere	all over	everywhere
編	compilation	compile, knit	compile
冊	tome	counter for books	counter for books
典	code	standard work, canon	code
氏	family name	courtesy title, family name	family name
紙	paper	paper	paper
婚	marriage	marry	marriage
低	lower	low	low
抵	resist	resist	resist
底	bottom	bottom	bottom
民	people	people	people
眠	sleep	sleep	sleep
捕	catch	catch	catch
浦	bay	seaside	bay
蒲	bulrush		
舗	shop	pave, shop	pavement
補	supplement	supplement	supplement
邸	residence	stately residence	residence
郭	enclosure	outer enclosure	enclosure
郡	county	county	county
郊	outskirts	suburb	outskirts
部	section	section	part
都	metropolis	metropolis, metropolis of Tokyo	metropolis
郵	mail	mail	mail
邦	home country	state, Japan	home country
郷	home town	hometown	home town
響	echo	reverberate	echo
郎	son	young man, male name suffix	son
廊	corridor	corridor	corridor
盾	shield	shield	shield
循	sequential	circulate	sequential
派	faction	sect, dispatch	sect
脈	vein	vein, pulse	vein
衆	masses	multitude	masses
逓	parcel post	relay	relay
段	grade	step	steps
鍛	forge	forge	forge
后	empress	empress	empress
幻	phantasm	phantom	phantasm
司	director	officiate	director
伺	pay respects	inquire	pay respects
詞	part of speech	words	poetry
飼	domesticate	raise animals	domesticate
嗣	heir	heir	heir
舟	boat	small boat	boat
舶	liner	oceangoing ship	liner
航	navigate	navigate	cruise
般	carrier	sort	generally
盤	tray	disk, board	tray
搬	conveyor	carry	conveyor
船	ship	ship	boat
艦	warship	warship	warship
艇	rowboat	boat	rowboat
瓜	melon		
弧	arc	arc	arc
孤	orphan	solitary	orphan
繭	cocoon	cocoon	cocoon
益	benefit	benefit, profit	benefit
暇	spare time	free time	spare time
敷	spread	lay	spread
来	come	come	come
気	spirit	gas, spirit	feeling
汽	vapor	steam	steam
飛	fly	fly	fly
沈	sink	sink	sink
妻	wife	wife	wife
衰	decline	decline	decline
衷	inmost	inner heart	inmost
面	mask	face	face
革	leather	leather, reform	leather
靴	shoes	shoes	shoes
覇	hegemony	supremacy	hegemony
声	voice	voice	voice
呉	give	Kingdom of Wu	give
娯	recreation	enjoyment	recreation
誤	mistake	mistake	mistake
蒸	steam	steam, evaporate	steam
承	acquiesce	agree to	acquiesce
函	bin		
極	poles	extreme, pole	poles
牙	tusk		tusk
芽	bud	bud	bud
邪	wicked	evil	wicked
雅	gracious	elegant	gracious
釈	explanation / interpretation	elucidate	explanation
番	turn	numerical order, watch	one's turn
審	hearing	examine carefully, try	examine
翻	flip	turn over, render	flip
藩	clan	feudal domain	clan
毛	fur	hair	hair
耗	decrease	wear away	decrease
尾	tail	tail	tail
宅	home	dwelling house	home
託	consign	entrust	consign
為	do	do, sake	do
偽	falsehood	falsify	falsehood
長	long	long, chief	long
張	lengthen	spread, strain	stretch
帳	notebook	notebook	account book
脹	dilate	swell	
髪	hair of the head	hair	hair of the head
展	unfold	unfold, display	expand
喪	miss	mourning	miss
巣	nest	nest	nest
単	simple	single	simple
戦	war	war	war
禅	zen	zen	Zen
弾	bullet	projectile, spring back	bullet
桜	cherry tree	cherry	cherry tree
獣	animal	beast	animal
脳	brain	brain	brain
悩	trouble	suffer	trouble
厳	stern	severe	strict
鎖	chain	chain	chain
挙	raise	nominate, noteworthy act, raise	raise
誉	reputation	honor	reputation
猟	game hunting	hunting	game-hunting
鳥	bird	bird	bird
鳴	chirp	cry, sound	chirp
鶴	crane	crane	crane
烏	crow		
蔦	vine	Japanese ivy	
鳩	pigeon	pigeon	
鶏	chicken	chicken	chicken
島	island	island	island
暖	warmth	warm	warmth
媛	beautiful woman		princess
援	abet	aid	aid
緩	slacken	slack	slacken
属	belong	belong to 	belong
嘱	entrust	charge with	entrust
偶	accidentally	by chance, couple	accidentally
遇	interview	treat, encounter	interview
愚	foolish	foolish	foolish
隅	corner	nook	corner
逆	inverted	reverse	inverted
塑	model	model	model
岡	mount	hill	hill
鋼	steel	steel	steel
綱	hawser	essential points, rope	hawser
剛	sturdy	tough	sturdy
缶	tin can	can	tin can
陶	pottery	pottery	pottery
揺	swing	shake	swing
謡	noh chanting	popular song	noh chanting
就	concerning	set about	concerning
懇	sociable	earnest, familiar	sociable
墾	groundbreaking	reclaim	ground-breaking
免	excuse	exempt	excuse
逸	deviate / elude	let slip	deviate
晩	nightfall	evening	nightfall
勉	exertion	endeavor	exertion
象	elephant	phenomenon, elephant	elephant
像	statue	image	statue
馬	horse	horse	horse
駒	pony	horse, chessman	horse
験	verification	test	test
騎	equestrian	ride on horseback	equestrian
駐	stop-over / parking	stationed	stop-over
駆	drive	drive	drive
駅	station	station	station
騒	boisterous	clamor	boisterous
駄	burdensome	good for nothing	burdensome
驚	wonder	surprise	wonder
篤	fervent	devoted	fervent
騰	inflation	rise	inflation
虎	tiger	tiger	tiger
虜	captive	captive	captive
膚	skin	skin	skin
虚	void	void, false	void
戯	frolic	sport	frolic
虞	uneasiness	fears	uneasiness
慮	prudence	consider	prudence
劇	drama	drama	drama
虐	tyrannize	cruel	tyrannize
鹿	deer	deer	deer
薦	recommend	recommend	recommend
慶	jubilation	felicitation	jubilation
麗	lovely	of graceful beauty	lovely
熊	bear	bear	bear
能	ability	ability	ability
態	attitude	state	condition
寅	sign of the tiger	the tiger	
演	performance	perform	perform
辰	sign of the dragon	the dragon	
辱	embarrass	humiliate	embarrass
震	quake	quake	quake
振	shake	swing	shake
娠	with child	conceive	with child
唇	lips	lip	lips
農	agriculture	farming	farming
濃	concentrated	thick	concentrated
送	escort / send off	send	send
関	connection	concern, barrier	related
咲	blossom	bloom	blossom
鬼	ghost	devil	ghost
醜	ugly	ugly	ugly
魂	soul	soul	soul
魔	witch	demon	witch
魅	fascination	charm	fascination
塊	clod	lump	clod
襲	attack	raid	attack
嚇	menacing / upbraid	intimidate	menacing
朕	majestic plural	imperial we	majestic plural
雰	atmosphere	atmosphere	atmosphere
箇	item	counter for items	counters for things
錬	tempering	refine	tempering
遵	abide by	obey	abide by
罷	quit	dismiss	quit
屯	barracks	station troops	barracks
且	moreover	as well	moreover
藻	seaweed	algae	seaweed
隷	slave	underling	slave
癒	healing	heal	healing
丹	rust colored / cinnabar	cinnabar	cinnabar
潟	lagoon	lagoon	lagoon
丑	sign of the cow	the ox	
卯	sign of the hare	the hare	
巳	sign of the snake	the serpent	
此	this here		
柴	brushwood		
砦	fort		
些	whit		
髭	beard		
璃	crystal	glassy substance	glassy
禽	fowl		
檎	apple		
憐	sympathize with		
燐	phosphorus		
麟	camelopard		
鱗	scaled		
奄	encompassing		
庵	hermitage		
掩	shrouded		
俺	myself	I	I, we
悛	make amends		
駿	steed	fleet steed	
峻	steep	stern	
竣	complete a job		
臼	mortar		mortar
舅	father-in-law		
鼠	mouse		
鑿	bore		
毀	break		destroy
艘	small craft		
犀	rhinoceros		
皐	lunar month		
脊	spinal column		stature
畷	rice-field footpath		
綴	mend		
爾	let it be	that	
璽	imperial seal	imperial seal	emperor's seal
鎧	suit of armor		
凱	triumph		
妖	bewitched		bewitching
沃	irrigate		fertility
呑	quaff		
韮	leek		
籤	lottery		
懺	penitential		
芻	hay		
雛	chick		
趨	scurry		
尤	understandably		
稽	training		consider
厖	immense		
采	grab		form
或	a  (a certain)		
斬	chop off		kill by slicing
兎	rabbit		
也	est	classical copula	
尭	lofty	yao	
巴	comma-design	circular comma pattern	
甫	offspring	barely	
疋	critters		
菫	violet		
曼	mandala		
巾	towel		towel
云	quote	such	
卜	augury		
喬	heaven-high	tall	
莫	shalt		
倭	Yamato		
侠	chivalry		
倦	fed up		
佼	comely		
俄	abrupt		
佃	work a field		
伶	minstrel	musician	
仔	animal offspring		
仇	foe		
伽	look after		
僅	trifle		a wee bit
僻	biased		
儲	make a profit		
倖	bliss		
僑	emigrant		
侶	partner		companion
伎	performing artist		deed
侃	integrity		
倶	mate		
侭	as is		
佑	adjutant	help	
俣	fork in a road		
傭	hire		
偲	memorial		
脩	dried meat	dried meat	
倅	my son		
做	make do		
凄	nifty		uncanny
冴	sharp	crisp and clear	
凋	wilt		
凌	pull through		
冶	metallurgy		melting
凛	stately		
凧	kite		
凪	lull		
夙	earlybird		
鳳	phoenix		
劉	slaughter		
刹	moment		temple
剥	peel off		peel
剃	shave		
匂	aroma		scent
勾	flexed		capture
厭	despondent		
雁	wild goose		
贋	counterfeit		
厨	kitchen		
仄	insinuate		
哨	scout		
嘲	derision		ridicule
咎	reprehend		
囁	whisper		
喋	chatter		
咽	windpipe		throat
嘩	quarrel		
噂	gossip		
咳	cough		
喧	clamor		
喉	throat		throat
唾	saliva		saliva
叩	bash		
嘘	fib		
啄	peck at		
呪	curse		charm
吠	barking		
吊	dangle		
噛	chew		
叶	within my ability		
吻	sides of the mouth		
吃	stammer		
噺	spin a tale		
噌	miso		
唄	pop song		songs with samisen
叱	scold	scold	scold
邑	city walls		
呆	dumbfounded		
喰	ingest		
埴	clay		
坤	authochthonous		
堆	piled high		piled high
壕	dugout		
垢	blemish		
坦	flat		
埠	wharf		
填	stuff up		fill in
堰	dam		
堵	railing		
嬰	suckling infant		
姦	violate		
妬	jealous		jealousy
婢	handmaiden		
婉	well finished		
娼	harlot		
妓	courtesan		
娃	fair		
姪	niece		
嫉	envy		envy
嬬	mistress		
姥	aged woman		
姑	mother-in-law		
姐	young miss		
嬉	overjoyed	glad	
孕	expecting		
孜	assiduous		
宥	soothe		
寓	imply		
宏	extensive	grand	
牢	jail		
塞	block up		obstruct
宋	Sung dynasty		
宍	venison		
屠	butchering		
屁	fart		
屑	rubbish		
尻	buttocks	buttocks	buttocks
屡	frequently		
屍	corpse		
屏	folding screen		
嵩	high-reaching	bulk	
崚	rugged mountains		
峨	high mountain		
崖	bluffs		cliff
嶺	mountaintop	ridge	
嵌	fit into		
嵯	rocky		
帖	quire		
幡	banner		
幟	pennant		
庖	cleaver		
廓	licensed quarters		
庇	overhang		
鷹	hawk	hawk	
庄	shire	feudal village	
廟	tomb sanctuary		
彊	strengthen		
弥	more and more	phonetic (mi)	all the more
弛	loosen		
粥	rice gruel		
挽	lathe		
撞	bump into		
扮	disguise		
掠	pillage		
挨	shove		push open
掴	clutch		
捺	impress		
捻	wrenching		twist
掻	scratch		
撰	assortment		
拭	wipe		wipe
揃	muster	make uniform	
捌	deal with		
撹	churn up		
摺	rubbing		
按	press down on		
捉	nab		capture
拶	imminent		be imminent
播	disseminate		
揖	interpretation		
托	receptable		
捧	dedicate		
撚	twirl		
挺	counter for tools		
擾	commotion		
捗	make headway		make progress
撫	petting		
撒	sprinkle		
擢	outstanding		
捷	spoils		
抉	gouge out		
怯	wince		
惟	ponder	mediate	
惚	infatuation		
怜	quickwitted	clever	
惇	considerate	sincere	
憧	yearn		desire
恰	as if		
恢	enlarge		
悌	respect for elders	brotherly love	
湧	bubble up		boil
澪	canal		
洸	glistening	vast	
滉	bounding main		
漱	gargle		
洲	continent		
洵	swirling waters	truly	
滲	seep		
洒	rinse		
沐	douse		
泪	teardrops		
渾	gushing		
沙	grains of sand	sand	sand
涜	blaspheme		
淫	lewd		lewdness
梁	roofbeam		
澱	sediment		
氾	widespread		spread out
洛	old Kyoto		
汝	thou		
漉	filter		
瀕	on the verge of		
濠	moat		
溌	spray		
溺	drowning		drown
湊	port		
淋	solitude		
浩	abounding	vast	
汀	water’s edge		
鴻	large goose		
潅	souse		
溢	brimming		
汰	cleanse		luxury
湛	inundate		
淳	immaculate	purehearted	
潰	defile		crush
渥	moisten	gracious	
灘	rough seas		
汲	draw water		
瀞	river pool		
溜	cumulation		
渕	abyss		
沌	chaos		
汎	pan-		pan-
濾	strainer		
濡	drench		
淀	eddy		
涅	fabrication		
釜	cauldron		kettle
斧	hatchet		
爺	grandpa		
猾	sly		
猥	indecent		
狡	cunning		
狸	racoon dog		
狼	wolf		
狽	flustered		
狗	pup		
狐	fox		
狛	a-un		
狙	aim at		aim at
獅	lion		
狒	baboon		
莨	tobacco		
茉	jasmine	jasmine	
莉	hawthorn	jasmine	
苺	strawberry		
萩	bush clover	hagi	
藝	technique (old)		
薙	trim		
蓑	straw raincoat		
萎	numb		wither
苔	moss		
蕩	prodigal		
蔽	cover over		cover
蔓	tendril		
蓮	lotus		
芙	lotus flower	lotus	
蓉	lotus blossom	cotton rose	
蘭	orchid	orchid	
芦	hollow reed		
薯	yam		
菖	iris		
蕉	banana		
芯	wick		wick
蕎	buckwheat		
蕗	butterbur	butterbur	
藍	indigo	indigo	indigo
茄	eggplant		
苛	bullying		torment
蔭	behind the scenes		
蓬	wormwood		
芥	mustard		
萌	germinate	germinate	
葡	grape		
萄	grape vine		
蘇	resurrect		
蕃	grow wild		
苓	cocklebur		
菰	rush mat		
蒙	darken		
茅	grassy reed		
芭	plantain		
苅	mow		
蓋	lid		cover
葱	onion		
蔑	revile		ignore
葵	hollyhock	mallow	
葺	shingling		
蕊	stamen		
茸	mushroom		
蒔	sowing		
芹	parsley		
苫	thatching		
葛	kudzu		arrowroot
蒼	pale blue		
藁	straw		
蕪	turnip		
藷	sweet potato		
薮	quack		
蒜	garlic		
蕨	bracken		
蔚	grow plentiful		
茜	madder red	madder	
莞	candle rush		
蒐	collector		
菅	sedge		
葦	ditch reed		
迪	Way	edify	
辿	track down		
這	crawl		
迂	detour		
遁	elude		
逢	tryst		
遥	far off	far	
遼	remote	faraway	
逼	pressing		
迄	until	up to	
遜	modest		humble
逗	standstill		
郁	cultured	aromatic	
鄭	courtesy		
隙	chink		fissure
隈	nook		
憑	possessed		
惹	attract		
悉	without exception		
忽	instantaneously		
惣	firstborn son	general	
愈	in the nick of time		
恕	sensitive		
昴	overarching		
晋	progress	jin dynasty	
曖	equivocal		not clear
晟	aglow		
暈	halo		
暉	glitter		
旱	dry weather		
晏	clear skies		
晨	morrow		
晒	bleaching		
昧	obscure		foolish
晃	limpid	dazzling	
曝	air out		
曙	dawn		
昂	elevate	high	
旺	effulgent		flourishing
昏	dusk		
晦	last day of the month		
腎	kidney		kidney
股	thigh		crotch
膿	pus		
腑	viscera		
胱	bladder		
胚	embryo		
肛	anus	anus	
臆	cowardice		timidity
膝	knee		knee
脆	fragile		
肋	rib		
肘	elbow		elbow
腔	body cavity		
腺	gland	gland	gland
腫	tumour		tumor
膳	dining tray		tray
肱	armrest		
胡	uncivilized		
楓	maple tree	maple	
枕	pillow		pillow
楊	purple willow		
椋	Oriental elm		
榛	hazel		
櫛	comb		
槌	wooden hammer		
樵	mallet		
梯	ladder		
椅	chair		chair
柿	persimmon		persimmon
柑	citrus tree		
桁	girder		beam
杭	picket		
柊	holly		
柚	citron		
椀	wooden bowl		
栂	hemlock		
柾	spindle tree		
榊	sacred Shinto tree		
樫	evergreen oak		
槙	Chinese black pine	podocarpus	
楢	Japanese oak		
橘	mandarin orange	mandarin	
桧	Japanese cypress		
棲	roost		
栖	nestle		
梗	spiny		close up
桔	bellflower		
杜	temple grove		
杷	grain rake		
梶	oar		
杵	wooden pestle		
杖	cane		
椎	sweet oak		oak
樽	barrel		
柵	palisade		fence
櫓	turret		
橿	sturdy oak		
杓	wooden ladle		
李	damson	plum	
棉	raw cotton		
楯	escutcheon		
榎	hackberry		
樺	birch		
槍	lance		
柘	wild mulberry		
梱	bale		
枇	loquat		
樋	downspout		
橇	sled		
槃	enjoyment		
栞	bookmark		
椰	coconut tree		
檀	sandalwood		
樗	plotosid		
槻	zelkova		
椙	cryptomeria		
彬	copious	refined and gentle	
桶	bucket		
楕	ellipse		
樒	star-anise		
毬	furball		
燿	twinkle		
燎	watchfire		
炬	torch		
焚	kindle		
灸	moxa		
燭	candlelight		
煽	fanning		
煤	soot		
煉	firing		
燦	dazzling		
灼	refulgent		
烙	branding		
焔	flames		
熔	fuse metal		
煎	roast		broil
烹	stew		
牽	tug		
牝	female animal		
牡	male animal		
瑶	precious stone	exquisite	
琳	chime		
瑠	marine blue	lapis lazuli	lapis lazuli
斑	speckled		blemish
琉	lapis lazuli		
弄	tinker with		tamper with
瑳	burnish		
琢	hone	polish	
珊	coral		
瑚	coral reef		
瑞	fortunate	auspicious omen	
珪	silicon		
玖	jet		
瑛	crystal stone	transparent gem	
玩	toy		trifle with
玲	tinkling	tinkling of jades	
畏	apprehensive		fear
畢	lastly		
畦	paddy-field ridge		
痒	itch		
痰	phlegm		
疹	measles		
痔	hemorrhoids		
癌	cancer		
痩	lose weight		get thin
痕	scar		mark
痺	paralysis		
眸	apple of the eye	eye	
眩	dizzy		
瞭	obvious		clear
眉	eyebrow		eyebrow
雉	pheasant		
矩	carpenter’s square	rule	
磐	crag		
碇	grapnel		
碧	blue-green	deep blue	
硯	inkstone		
砥	grindstone		
碗	teacup		
碍	obstacle		
碩	illustrious		
磯	rocky beach	rocky beach	
砺	whetstone		
碓	mill		
禦	fend off		
祷	beseech		
祐	ancestral tablet	divine help	
祇	local god		
祢	ancestral shrine		
禄	salarium	retainer’s stipend	
禎	felicitation	propitious omen	
秤	balancing scales		
黍	millet		
禿	bald		
稔	bear fruit	ripen	
稗	crabgrass		
穣	bumper crop	yielding abundantly	
稜	imperial authority		
稀	sparse		
穆	obeisant		
窺	peep		
窄	tight		
窟	cavern		cavern
穿	drill		
竃	kitchen stove		
竪	longness		
颯	rustling		
站	outpost		
靖	repose	pacify	
妾	concubine		
衿	lapel		
裾	hem		cuff
袷	lined kimono		
袴	pleated skirt		
襖	sliding door		
笙	Chinese panpipe		
筏	raft		
簾	bamboo blinds		
箪	rattan box		
竿	pole		
箆	spatula		
箔	foil		
笥	wardrobe		
箭	arrow shaft		
筑	ancient harp		
篭	cage		
篠	slender bamboo		
箸	chopsticks		chopsticks
纂	redaction		
竺	bamboo cane		
箕	winnowing fan		
笈	backpack		
篇	livraison		
筈	should		
簸	winnow		
粕	settlings		
糟	lees		
糊	paste		
籾	unhulled rice		
糠	rice bran		
糞	excrement		
粟	foxtail millet		
繋	link up		
綸	twine		
絨	carpet yarn		
絆	ties		
緋	scarlet	scarlet	
綜	synthesis		
紐	string		
紘	chinstrap	wide-ranging	
纏	summarize		
絢	gorgeous	gorgeous	
繍	embroidery		
紬	pongee		
綺	ornate		
綾	damask	twill	
絃	catgut		
綻	come apart at the seams		rip
縞	stripe		
綬	gimp		
紗	gossamer	gauze	
舵	rudder		
舷	gunwale		gunwale
聯	strung together		
聡	attentive	sharp-witted	
聘	summons		
耽	addiction		
耶	exclamation	interrogative particle	
蚤	flea		
蟹	crab		
蛋	protein		
蟄	hibernation		
蝿	housefly		
蟻	ant		
蜂	bee		bee
蝋	wax		
蝦	shrimp		
蛸	octopus		
螺	screw		
蝉	cicada		
蛙	frog		
蛾	moth		
蛤	clam		
蛭	leech		
蛎	oyster		
罫	ruled lines		
罵	insult		insult
袈	stole		
裟	monk’s sash		
戴	accept humbly	receive humbly	be crowned with
截	incision		
哉	I wonder	exclamatory particle	
詢	counsel		
諄	polite		
讐	vendetta		
諌	remonstrate		
謎	riddle		riddle
諒	verify	understand	
讃	compliment		
誰	who?	who	who (question word)
訊	query		
訣	split up		
詣	visit a shrine		visit a temple
諦	give up		abandon
詮	elucidate		discussion
詑	prevarication		
誼	familiarity		
謬	fallible		
詫	beg pardon		
諏	advise		
諺	proverb		
誹	slander		
謂	so-called		
諜	secret agent		
註	footnote		
譬	parable		
轟	rumble		
輔	reinforce	assist	
輻	spoke		
輯	assemble		
貌	countenance		appearance
豹	panther		
賎	despicable		
貼	affix		paste
貰	get		
賂	graft		bribe
賑	bustling		
躓	stumble		
蹄	hoof		
蹴	kick		kick
蹟	vestiges		
跨	straddle		
跪	kneel		
醤	soy sauce		
醍	whey		
酎	hooch		sake
醐	ghee		
醒	awakening		be disillusioned
醇	strong sake		
麺	noodles		noodles
麹	malt		
釦	button		
銚	keg		
鋤	plow		
鍋	pot	pot	pot
鏑	arrowhead		
鋸	hand saw		
錐	awl		
鍵	key	key	key
鍬	hoe		
鋲	rivet		
錫	tin		
錨	anchor		
釘	nail		
鑓	javelin		
鋒	sword’s point		
鎚	hammer		
鉦	carillion		
錆	rust		
鍾	cluster		
鋏	scissors		
閃	flash		
悶	agony		
閤	side gate		
闇	pitch dark		darkness
雫	trickle		
霞	haze	mist	
翰	quill		
斡	auspices		
鞍	saddle		
鞭	whip		
鞘	saddle straps		
鞄	briefcase		
靭	pliable		
鞠	terminate		
頓	immediate		suddenly
顛	overturn		
穎	brush tip		
頃	about that time	time, about	times
頬	cheek		cheek
頗	exceedingly		
頌	accolade	eulogize	
顎	chin		jaw
頚	neck and throat		
餌	feed		bait
餐	repast		
饗	feast		
蝕	eclipse		
飴	sweets		
餅	mochi		mochi rice cake
駕	stretcher		
騨	piebald		
馳	rush		
騙	cheat		
馴	tame		
駁	rebuttal		
駈	gallop		
驢	donkey		
鰻	eel		
鯛	sea bream	tai	
鰯	sardine		
鱒	trout		
鮭	salmon		
鮪	tuna		
鮎	sweet smelt	ayu	
鯵	horse mackerel		
鱈	cod		
鯖	mackerel		
鮫	shark		
鰹	bonito		
鰍	bullhead		
鰐	alligator		
鮒	crucian		
鮨	sushi		
鰭	fish fin		
鴎	seagull		
鵬	roc		
鸚	parakeet		
鵡	parrot		
鵜	cormorant		
鷺	heron		
鷲	eagle		
鴨	wild duck		
鳶	kite falcon		
梟	owl		
塵	dust		
麓	foot of a mountain		foot of a mountain
麒	giraffe		
冥	hades		dark
瞑	close the eyes		
暝	murky		
坐	sitting in meditation		
挫	sprain		sprain
朔	first day of the month		
遡	go upstream		go upstream
曳	drag		
洩	dribble out		
彗	comet		
慧	astute	intelligent	
嘉	applaud	happy	
兇	evil		
兜	helmet		
爽	bracing		refreshing
欝	depressed		
劫	kalpa		
勃	erection		rise
歎	bemoan		
輿	palanquin		
巽	southeast		
歪	warped		
翠	jade green	jade green	
黛	blue-black		
鼎	tripod		
鹵	rocksalt		
鹸	lye		
虔	reserved		
燕	swallow		
嘗	lick		
殆	almost		
孟	start	mencius	
牌	mahjong tiles		
骸	remains		dead remains
覗	peek		
彪	mottled		
秦	Manchu dynasty		
雀	sparrow	sparrow, mahjong	
隼	peregrine falcon	falcon	
耀	shimmering		
夷	ebisu		
戚	relatives		grieve
嚢	cyst		
丼	domburi		bowl of food
暢	carefree	fluent	
廻	circling		
畿	capital suburbs		capital
欣	elation	joyful	
毅	stalwart	resolute	
斯	this		
匙	wooden spoon		
匡	set straight	rectify	
肇	founding	originate	
麿	Utamaro	classical male name suffix	
叢	conglomerate		
肴	entreat		
斐	symmetrically patterned	phonetic (i)	
卿	magistrate		
翫	fiddle with		
於	within		
套	hackneyed		
叛	rebellion		
尖	sharp point		
壷	crock		
叡	sapience		
酋	chieftain		
鴬	nightingale		
赫	incandescent		
臥	supinate		
甥	nephew		
瓢	gourd		
琵	biwa		
琶	lute		
叉	forked		
舜	rose of Sharon		
畠	dry field		
拳	fist		fist
圃	vegetable patch		
丞	helping hand	aide	
亮	translucent	lucid	
胤	blood relative	progeny	
疏	transcription		
膏	ointment		
魁	pioneer		
馨	ambrosial	perfume	
牒	label		
瞥	glimpse		
阜	large hill		mound
睾	testicle		
巫	sorceress		
敦	empathetic	honest	
奎	Andromeda		
翔	soar	soar	
皓	beaming	bright white	
黎	tenebrous		
赳	bold	valiant	
已	stop short		
棘	thornbush		
聚	crowd		
甦	resuscitate		
剪	pruning		
躾	upbringing		
夥	plentiful		
鼾	snore		
祟	cast a spell		
粁	kilometer		
糎	centimeter		
粍	millimeter		
噸	ton		
哩	mile		
浬	nautical mile		
吋	inch		
呎	feet		
梵	brahman		
陀	Shakyamuni Buddha		
薩	bodhisattva		
菩	bo tree		
唖	babble		
迦	Sanskrit ka		
那	interrogative	phonetic (na)	what
牟	moo		
珈	jeweled hairpin		
琲	beaded hairpin		
檜	Japanese cypress (old)		
轡	bridle’s bit		
淵	abyss (old)		
伍	V	rank	
什	X		
萬	ten thousand (old)		
邁	pass through		
逞	tough		
燈	lamp (old)		
裡	back (old)		
薗	park (alternate)		
鋪	shop (alternate)		
嶋	island (alternate)		
峯	summit (alternate)		
巌	boulder (old)	crag	
埜	plains (old)		
舘	Bldg. (old)		
龍	dragon (old)	dragon	
寵	patronage		
聾	deafness		
慾	longing (old)		
亙	span (old)		
躯	body (old)		
嶽	Point (old)		
國	country (old)		
脛	shin		
勁	formidable		
箋	stationary (sic)		paper
祀	enshrine		
祓	exorcism		
躇	dither		
壽	longevity (old)		
躊	hesitate		
彙	glossary		same kind
饅	bean jam		
嘔	retch		
鼈	snapping turtle		
亨	go smoothly	go smoothly	
侑	condone	urge to eat	
梧	parasol tree		
欽	circumspect	revere	
煕	cheer		
而	and then		
掟	mandate		
嗅	sniff		smell
喩	metaphor		metaphor
訃	obituary		obituary
楷	block letters		square character style
諧	orderliness		harmony
錮	weld		tie up
恣	selfish		selfish
惧	disquieting		dread
憬	hanker		long for
拉	yank		crush
傲	arrogance		be proud
踪	trail		remains
緻	fine		fine (not coarse)
璧	holed gem		sphere
摯	clasp		seriousness
貪	covet		covet
慄	shudder		fear
辣	bitter		bitter
瘍	carbuncle		boil (medical)
哺	suckle		suckle
籠	basket	basket	basket
羞	humiliate		feel ashamed
鬱	gloom		gloom
